1111111111
1PCE000CW1
10000CW001
1WC00000C1
1111111111
