1111111111111
1001P0010C011
1C010100000C1
100C011111011
100011E00000C
1111111111111