1111111111111
1001P00100011
1001010000001
1000011111011
100011E000001
1111111111111