1111111111111
1001P0P10C011
1C010100000C1
100C011111011
100011E000001
1111111111111