1111111111111
1001P0010C01
1C010100000C
100C011111011
100011E00001
1111111111111