111111111111111
1C1000111000001
100010000011001
10011111001C001
100100C10011111
100101110010001
1P01000000001E1
111111111111111